0 0 0 0 0 0 0 0 0 0 0 0 0
0 1 1 1 1 1 9 2 2 2 2 2 0
0 1 0 0 0 0 9 0 0 0 0 2 0
0 1 0 0 0 0 9 0 0 0 0 2 0
0 1 0 0 0 0 9 0 0 0 0 2 0
0 1 0 0 0 0 9 0 0 0 0 2 0
0 1 1 1 1 1 9 2 2 2 2 2 0
0 0 0 0 0 0 0 0 0 0 0 0 0

0 1 2 3 4 5 6 7 8 9 0 1 2